一下 yīxià: một tý, thử xem, bỗng chốc.
一些 yīxiē: một ít, một số, hơi, một chút.
一个 yīgè: một cái, một.
一切 yīqiè: tất cả, hết thảy, toàn bộ.
一定 yīdìng: chính xác, cần phải, nhất định.
一样 yīyàng: giống nhau, cũng thế.
一直 yīzhí: thẳng, luôn luôn, liên tục.
一起 yīqǐ: cùng nơi, cùng, tổng cộng.
一点 yīdiǎn: một chút, một ít, chút xíu, chút ít.
丈夫 zhàngfū: chồng.
上帝 shàngdì: thượng đế, chúa trời.
上面 shàngmiàn: bên trên, phía trên.
下来 xiàlái: xuống, lại, tiếp.
下去 xiàqù: xuống, đi xuống, tiếp nữa.
下面 xiàmiàn: phía dưới, bên dưới.
不再 bù zài: không lặp lại , không có lần thứ hai.
不同 bùtóng: không giống, không cùng.
不好 bù hǎo: không tốt.
不用 bùyòng: không cần.
不管 bùguǎn: cho dù, bất luận, mặc kệ, bỏ mặc.
不能 bùnéng: không thể, không được.
不行 bùxíng: không được.
不要 bùyào: đừng, không được, chớ.
不过 bùguò: cực kỳ, nhất trên đời, nhưng, nhưng mà, có điều.
不错 bùcuò: đúng, đúng vậy, không tệ.
世界 shìjiè: thế giới, vũ trụ, trái đất.
并且 bìngqiě: đồng thời, hơn nữa, vả lại.
主意 zhǔyì: chủ kiến , chủ định.
之前 zhīqián: trước, trước khi (thời gian)
之后 zhīhòu: sau, sau khi.
之间 zhī jiān: giữa.
也许 yěxǔ: có lẽ, e rằng, biết đâu.
了解 liǎojiě: hiểu rõ, biết rõ, hỏi thăm.
事儿 shì er: sự việc.
事实 shìshí: sự thực.
事情 shìqíng: sự việc, sự tình.
人们 rénmen: mọi người, người ta.
人类 rénlèi: loài người, nhân loại.
什么 shénme: cái gì, hả.
今天 jīntiān: ngày hôm nay, hôm nay, hiện tại, trước mắt.
今晚 jīn wǎn: tối nay.
介意 jièyì: để ý, để bụng, lưu tâm.
他们 tāmen: bọn họ.
代表 dàibiǎo: đại biểu, đại diện.
以前 yǐqián: trước đây, trước kia, ngày trước.
以及 yǐjí: và, cùng.
以后 yǐhòu: sau đó, về sau, sau này.
以为 yǐwéi: tin tưởng, cho rằng.
任何 rènhé: bất luận cái gì.
任务 rènwù: nhiệm vụ.
休息 xiūxí: nghỉ ngơi, nghỉ.
伙计 huǒji: người cộng tác, bạn cùng nghề, làm thuê, người làm mướn.
但是 dànshì: nhưng, mà.
作为 zuòwéi: hành vi, làm được, với tư cách.
你们 nǐmen: bọn họ.
来自 láizì: đến từ.
来说 lái shuō: …mà nói.
保持 bǎochí: duy trì, gìn giữ.
保证 bǎozhèng: bảo đảm.
保护 bǎohù: bảo hộ, bảo vệ.
信任 xìnrèn: tín nhiệm.
信息 xìnxī: tin tức, thông tin.
个人 gèrén: cá nhân.
做到 zuò dào: làm được.
家伙 jiāhuo: cái thứ, thằng cha, cái con.
伤害 shānghài: tổn thương, làm hại.
兄弟 xiōngdì: huynh đệ, anh em.
凶手 xiōngshǒu: hung thủ.
先生 xiānshēng: thầy, tiên sinh, chồng.
儿子 érzi: con trai, người con.
全部 quánbù: toàn bộ.
公司 gōngsī: công ty, hãng.
其中 qízhōng: trong đó.
其他 qítā: cái khác, khác.
其实 qíshí: kì thực, thực ra.
再见 zàijiàn: tạm biệt, chào tạm biệt.
冷静 lěngjìng: vắng vẻ, yên tĩnh, bình tĩnh.
出来 chūlái: đi ra, ra đây, xuất hiện, nảy ra.
出去 chūqù: ra, ra ngoài.
出现 chūxiàn: xuất hện, hiện ra.
分钟 fēnzhōng: phút
别人 biérén: người khác, người ta.
别的 bié de: cái khác.
到底 dàodǐ: đến cùng, rốt cuộc, tóm lại.
到处 dàochù: khắp nơi, mọi nơi, đâu đâu.
刚刚 gānggāng: vừa, mới.
刚才 gāng cái: vừa nãy.
加入 jiārù: gia nhập.
加油 jiāyóu: cố lên.
努力 nǔlì: nỗ lực, cố gắng.
博士 bóshì: tiến sĩ.
危险 wéixiǎn: nguy hiểm.
即使 jíshǐ: cho dù, dù cho.
原因 yuányīn: nguyên nhân.
原谅 yuánliàng: tha thứ, bỏ qua.
参加 cānjiā: tham gia, tham dự.
另外 lìngwài: ngoài ra.
只是 zhǐshì: chỉ là, chẳng qua là, chỉ, nhưng.
只有 zhǐyǒu: chỉ có.
只要 zhǐyào: chỉ cần, miễn là.
可以 kěyǐ: có thể.
可爱 kě'ài: đáng yêu.
可怜 kělián: đáng thương.
可是 kěshì: nhưng, thế nhưng, thật là.
可能 kěnéng: có thể, khả năng, chắc là.
各位 gèwèi: các vị.
同意 tóngyì: đồng ý, đồng tình.
名字 míngzì: tên (người, sự vật)
否则 fǒuzé: bằng không, nếu không.
告诉 gàosu: nói với, tố cáo, tố giác.
咖啡 kāfēi: cà phê.
咱们 zánmen: chúng ta.
哥哥 gēgē: anh trai.
哪儿 nǎr: chỗ nào, đâu.
哪里 nǎlǐ: đâu, nơi nảo, đâu có, đâu phải.
唯一 wéiyī: duy nhất.
问题 wèntí: vấn đề, câu hỏi.
喜欢 xǐhuan: thích, vui mừng.
回来 huílái: trở về, quay về.
回到 huí dào: về đến.
回去 huíqù: trở về, đi về.
回家 huí jiā: về nhà.
回答 huídá: trả lời, giải đáp.
因为 yīnwèi: bởi vì, bởi rằng.
国家 guójiā: quốc gia, đất nước.
地方 dìfāng: địa phương, bản xứ, vùng, miền.
坚持 jiānchí: kiên trì.
报告 bàogào: báo cáo, bản báo cáo, phát biểu.
外面 wàimiàn: phía ngoài, bên ngoài.
多久 duōjiǔ: bao lâu.
多少 duōshǎo: nhiều ít, bao nhiêu, mấy.
大学 dàxué: đại học.
大家 dàjiā: cả nhà, mọi người.
大概 dàgài: khoảng, chừng.
太太 tàitài: bà lớn, bà chủ, bà xã, bà nhà.
夫人 fūrén: phu nhân.
失去 shīqù: mất, chết.
奇怪 qíguài: kì lạ, kì quái.
女人 nǚrén: phụ nữ, đàn bà (người trưởng thành).
女儿 nǚ'ér: con gái.
女士 nǚshì: nữ sĩ, bà, phu nhân (ngoại giao).
女孩 nǚhái: cô gái.
她们 tāmen: họ, bọn họ.
好像 hǎoxiàng: hình như, na ná, giống như.
好好 hǎohǎo: vui sướng , tốt đẹp.
如何 rúhé: làm sao, như thế nào, ra sao.
如果 rúguǒ: nếu.
如此 rúcǐ: như thế, như vậy.
妻子 qīzi: vợ.
姑娘 gūniang: cô nương.
婚礼 hūnlǐ: hôn lễ.
妈妈 māmā: mẹ, má, u, bầm, bà già.
存在 cúnzài: tồn tại.
孩子 háizi: trẻ con, con cái.
学校 xuéxiào: trường học.
它们 tāmen: bọn họ, chúng nó.
安全 ānquán: an toàn.
安排 ānpái: sắp xếp, bố trí, trình bày.
完全 wánquán: đầy đủ, trọn vẹn, hoàn toàn.
完成 wánchéng: hoàn thành.
完美 wánměi: hoàn mỹ.
害怕 hàipà: sợ hãi, sợ sệt.
家庭 jiātíng: gia đình.
家里 jiāli: trong nhà.
容易 róngyì: dễ dàng, dễ.
实在 shízài: chân thực, quả thực, thực ra.
宝贝 bǎobèi: bảo bối, cục cưng, của báu.
对于 duìwū: về, đối với.
小姐 xiǎojiě: tiểu thư, cô.
小子 xiǎozi: người trẻ tuổi, con trai, thằng.
小孩 xiǎohái: trẻ em.
小心 xiǎoxīn: cẩn thận.
小时 xiǎoshí: tiếng đồng hồ, giờ.
就是 jiùshì: nhất định, đúng, dù cho.
屁股 pìgu: mông, đít.
尸体 shītǐ: thi thể, xác chết.
工作 gōngzuò: công việc, công tác.
已经 yǐjīng: đã, rồi.
希望 xīwàng: mong muốn, hy vọng, ước ao.
带来 dài lái: đem lại.
帮助 bāngzhù: giúp đỡ, viện trợ.
帮忙 bāngmáng: giúp đỡ.
年轻 niánqīng: tuổi trẻ, thanh niên.
幸运 xìngyùn: vận may, dịp may.
干吗 gànma: làm gì.
建议 jiànyì: kiến nghị, đề xuất, sáng kiến.
弟弟 dìdì: em trai.
很多 hěnduō: rất nhiều.
很快 hěn kuài: rất nhanh.
律师 lǜshī: luật sư.
后面 hòumiàn: phía sau, đằng sau.
得到 dédào: đạt được, nhận được.
从来 cónglái: chưa hề, từ trước tới nay.
从没 cóng méi: chưa bao giờ, không bao giờ.
必要 bìyào: cần thiết, thiết yếu.
必须 bìxū: nhất định phải, nhất thiết phải.
忘记 wàngjì: quên.
快乐 kuàilè: vui vẻ.
怎样 zěnyàng: thế nào, ra sao.
怎么 zěnme: thế nào, sao, như thế.
情况 qíngkuàng: tình hình, tình huống.
想像 xiǎngxiàng: tưởng tượng.
想到 xiǎngdào: nghĩ đến.
想想 xiǎng xiǎng: nghĩ .
想法 xiǎngfǎ: cách nghĩ, ý nghĩ.
意思 yìsi: ý, ý nghĩa.
意义 yìyì: ý nghĩa.
感到 gǎndào: cảm thấy, thấy.
感觉 gǎnjué: cảm giác, cảm thấy, cho rằng.
感谢 gǎnxiè: cảm tạ, cảm ơn.
应该 yīnggāi: nên, cần phải.
成功 chénggōng: thành công.
成为 chéngwéi: trở thành, biến thành.
我们 wǒmen: chúng tôi.
或者 huòzhě: có lẽ, hoặc, hoặc là.
或许 huòxǔ: có thể, có lẽ, hay là.
房子 fángzi: nhà, cái nhà.
房间 fángjiān: phòng, gian phòng.
所以 suǒyǐ: cho nên, sở dĩ, nguyên cớ.
所有 suǒyǒu: sở hữu, tất cả, toàn bộ.
手机 shǒujī: Điện thoại di động
手术 shǒushù: phẫu thuật.
打算 dǎsuàn: dự định, dự kiến.
打开 dǎkāi: mở ra.
找到 zhǎodào: tìm thấy.
承认 chéngrèn: thừa nhận.
抓住 zhuā zhù: bắt được , túm được.
投票 tóupiào: bỏ phiếu.
抱歉 bàoqiàn: không phải, ân hận, có lỗi.
拜托 bàituō: xin nhờ, kính nhờ.
接受 jiēshòu: tiếp nhận , tiếp thu, nhận.
控制 kòngzhì: khống chế.
撒谎 sāhuǎng: nói dối, bịa đặt.
拥有 yǒngyǒu: có.
担心 dānxīn: lo lắng, không yên tâm, lo âu.
支持 zhīchí: ủng hộ.
收到 shōu dào: nhận được.
改变 gǎibiàn: thay đổi, sửa đổi.
放弃 fàngqì: bỏ cuộc, từ bỏ.
放松 fàngsōng: thả lỏng, buông lỏng, lơ là.
政府 zhèngfǔ: chính phủ.
故事 gùshì: câu chuyện.
整个 zhěnggè: toàn bộ, tất cả, cả thay.
新闻 xīnwén: tin tức thời sự, việc mới xảy ra.
方式 fāngshì: phương thức, cách thức, kiểu.
方法 fāngfǎ: phương pháp, cách làm.
早上 zǎoshang: buổi sáng.
明天 míngtiān: ngày mai, mai đây.
明白 míngbái: rõ ràng, công khai, hiểu biết.
星期 xīngqí: tuần lễ, ngày thứ, chủ nhật (gọi tắt).
昨天 zuótiān: hôm qua.
昨晚 zuó wǎn: tối hôm qua.
是否 shìfǒu: phải chăng, hay không.
是的 shì de: tựa như, giống như.
时候 shíhou: thời gian, lúc, khi.
时间 shíjiān: thời gian, khoảng thời gian.
晚上 wǎnshàng: buổi tối, ban đêm.
晚安 wǎn'ān: ngủ ngon.
曾经 céngjīng: trải qua, đã trải.
最后 zuì hòu: cuối cùng, sau cùng.
最近 zuìjìn: dạo này, gần đây.
有些 yǒuxiē: có một số, một ít,vài phần.
有人 yǒurén: có người, có ai…
有趣 yǒuqù: có hứng.
有关 yǒuguān: liên quan, hữu quan.
有点 yǒudiǎn: có chút.
朋友 péngyǒu: bạn bè, bằng hữu.
未来 wèilái: mai sau, sau này, tương lai.
本来 běnlái: ban đầu, trước đây, lẽ ra, đáng lẽ.
东西 dōngxi: đông tây, đồ vật.
根本 gēnběn: căn bản, chủ yếu, trước giờ.
案子 ànzi: bàn, bàn dài, vụ án, án kiện.
极了 jíle: rất, cực.
样子 yàngzi: hình dáng, dáng vẻ.
机会 jīhuì: cơ hội, dịp, thời cơ.
检查 jiǎnchá: kiểm tra.
欢迎 huānyíng: hoan nghênh, chào mừng.
正在 zhèngzài: đang.
正常 zhèngcháng: thường thường.
武器 wǔqì: vũ khí.
死亡 sǐwáng: chết, tử vong.
母亲 mǔqīn: mẹ, mẫu thân.
每个 měi gè: mỗi cái
每天 měitiān: mỗi ngày.
比赛 bǐsài: thi đấu, đấu.
比较 bǐjiào: tương đối.
永远 yǒngyuǎn: vĩnh viễn, mãi mãi.
决定 juédìng: quyết định.
没有 méiyǒu: không có, không bằng, chưa.
治疗 zhìliáo: trị liệu, chữa trị.
法官 fǎguān: quan tòa , tòa án.
注意 zhùyì: chú ý.
消息 xiāoxi: tin tức, thông tin.
混蛋 húndàn: thằng khốn, khốn nạn.
清楚 qīngchu: rõ ràng, tinh tường, hiểu rõ.
准备 zhǔnbèi: chuẩn bị, dự định.
漂亮 piàoliang: đẹp, xinh xắn.
为了 wèile: để, vì (biểu thị mục đích).
无法 wúfǎ: không còn cách nào.
然后 ránhòu: sau đó, tiếp đó.
照片 zhàopiàn: bức ảnh, bức hình.
照顾 zhàogù: chăm sóc.
父母 fùmǔ: cha mẹ.
父亲 fùqīn: phụ thân, bố, cha, ba.
爸爸 bàba: bố, cha, ông già.
特别 tèbié: đặc biệt.
犯罪 fànzuì: phạm tội , phạm lỗi.
玩笑 wánxiào: đùa.
现在 xiànzài: bây giờ.
现场 xiànchǎng: hiện trường.
理由 lǐyóu: lý do.
理解 lǐjiě: hiểu biết.
甚至 shènzhì: thậm chí.
生命 shēngmìng: sinh mệnh, mạng sống.
生意 shēngyì: buôn bán, làm ăn, sức sống, nảy nở.
生日 shēngrì: sinh nhật , ngày sinh.
生气 shēngqì: tức giận, giận dỗi.
生活 shēnghuó: đời sống, cuộc sống, sinh hoạt.
男人 nánrén: đàn ông, nam nhân.
男孩 nánhái: con trai
留下 liú xià: lưu lại.
当时 dāngshí: lúc đó, khi đó, lập tức, ngay.
当然 dāngrán: đương nhiên, tất nhiên, dĩ nhiên.
病人 bìngrén: người bệnh.
痛苦 tòngkǔ: đau khổ, thống khổ.
疯狂 fēngkuáng: điên rồ.
发现 fāxiàn: phát hiện, tìm ra, phát giác.
发生 fāshēng: sinh ra, xảy ra, sản sinh.
发誓 fāshì: thề, lời thề, xin thề.
白痴 báichī: ngớ ngẩn, thằng ngốc.
的确 díquè: đích thực.
监狱 jiānyù: nhà tù, nhà giam, nhà lao.
目标 mùbiāo: mục tiêu.
直到 zhídào: mãi đến, cho đến, tận đến.
直接 zhíjiē: trực tiếp.
相信 xiāngxìn: tin tưởng, tin.
看来 kàn lái: xem ra.
看到 kàn dào: nhìn thấy.
看看 kàn kàn: xem xét, xem.
看见 kànjiàn: thấy, trông thấy, nhìn thấy.
真是 zhēnshi: rõ là, thật là (không hài lòng).
真正 zhēnzhèng: chân chính.
真的 zhēn de: thật mà.
眼睛 yǎnjīng: đôi mắt.
睡觉 shuìjiào: ngủ.
知道 zhīdào: biết, hiểu, rõ.
确定 quèdìng: xác định, khẳng định.
确实 quèshí: xác thực, chính xác.
礼物 lǐwù: món quà, quà.
秘密 mìmì: bí mật.
突然 túrán: đột nhiên.
第一 dì yī: thứ nhất, hạng nhất, quan trọng nhất.
第二 dì èr: thứ hai (chỉ số thứ tự).
等等 děng děng: vân...vân, chờ một chút.
节目 jiémù: tiết mục, chương trình.
简单 jiǎndān: đơn giản.
简直 jiǎnzhí: quả là, tưởng chừng, dứt khoát.
精神 jīngshén: tinh thần.
糟糕 zāogāo: hỏng bét, gay go.
系统 xìtǒng: hệ thống.
约会 yuēhuì: hẹn hò, hẹn gặp.
纽约 niǔyuē: New York (Mỹ)
终于 zhōngwū: cuối cùng.
组织 zǔzhī: tổ chức.
结婚 jiéhūn: kết hôn.
结束 jiéshù: kết thúc, chấm dứt.
结果 jiéguǒ: kết quả.
绝对 juéduì: tuyệt đối.
经历 jīnglì: từng trải, trải qua, những việc trải qua.
紧张 jǐnzhāng: lo lắng, hồi hộp.
总是 zǒng shì: luôn luôn , lúc nào cũng.
总统 zǒngtǒng: tổng thống.
继续 jìxù: tiếp tục
继续 jìxù: tiếp tục, kéo dài, kế thừa, tiếp nối.
美元 měiyuán: đô la mỹ.
美国 měiguó: nước Mỹ
老兄 lǎoxiōng: anh bạn, ông anh.
老师 lǎoshī: giáo viên.
考虑 kǎolǜ: suy nghĩ, suy xét, cân nhắc.
而且 érqiě: mà còn, với lại.
而已 éryǐ: mà thôi.
联系 liánxì: liên hệ.
聪明 cōngmíng: thông minh.
声音 shēngyīn: âm thanh, tiếng động.
听到 tīngdào: nghe được.
听说 tīng shuō: nghe nói.
肯定 kěndìng: khẳng định, quả quyết, chắc chắn.
能力 nénglì: năng lực, khả năng.
能够 nénggòu: đủ.
自己 zìjǐ: tự mình, mình.
自由 zìyóu: tự do.
至少 zhìshǎo: chí ít, ít nhất.
兴趣 xìngqù: hứng thú, thích thú.
处理 chǔlǐ: xử lí, giải quyết.
行动 xíngdòng: hành động.
行为 xíngwéi: hành vi.
衣服 yīfú: quần áo, trang phục.
表演 biǎoyǎn: biểu diễn.
表现 biǎoxiàn: thể hiện, tỏ ra.
里面 lǐmiàn: bên trong, trong.
要求 yāoqiú: yêu cầu.
见到 jiàn dào: nhìn thấy, gặp mặt.
亲爱 qīn'ài: thân ái, thân thiết, thương yêu.
觉得 juéde: cảm thấy, thấy rằng.
解决 jiějué: giải quyết.
解释 jiěshì: giải thích.
计划 jìhuá: kế hoạch, lập kế hoạch.
讨厌 tǎoyàn: đáng ghét, ghét.
记住 jì zhù: ghi nhớ.
记得 jìde: nhớ, nhớ lại, còn nhớ.
记录 jìlù: ghi lại , ghi chép.
试试 shì shì: thử.
该死 gāisǐ: đáng chết, chết tiệt.
认为 rènwéi: cho rằng, cho là.
认识 rènshi: nhận biết, biết, nhận thức.
说话 shuōhuà: nói chuyện, trò chuyện, lời nói.
调查 diàochá: điều tra.
谈谈 tán tán: bàn về, thảo luận.
谋杀 móushā: mưu sát.
谢谢 xièxiè: cám ơn.
证据 zhèngjù: chứng cứ, bằng chứng.
证明 zhèngmíng: chứng minh.
警察 jǐngchá: cảnh sát.
变成 biànchéng: biến thành, trở thành.
负责 fùzé: phụ trách.
起来 qǐlái: đứng dậy, nổi dậy, vùng lên.
跳舞 tiàowǔ: nhảy múa.
身上 shēnshang: trên cơ thể, trên người.
身边 shēnbiān: bên cạnh, bên mình.
身体 shēntǐ: thân thể, cơ thể
办法 bànfǎ: cách, biện pháp.
这些 zhèxiē: những…này.
这个 zhè ge: cái này, việc này.
这儿 zhèr: ở đây, chỗ này, lúc này, bây giờ
这样 zhèyàng: như vậy, thế này.
这次 zhècì: lần này.
这种 zhè zhǒng: kiểu này, loại này.
这里 zhèlǐ: ở đây.
这边 zhè biān: bên này.
这么 zhème: như thế, như vậy, thế này.
通过 tōngguò: thông qua.
进来 jìnlái: gần đây, vừa qua.
进入 jìnrù: tiến vào, bước vào, đi vào.
进去 jìnqù: vào (từ ngoài vào trong)
进行 jìnxíng: tiến hành.
遇到 yù dào: gặp phải, bắt gặp.
游戏 yóuxì: trò chơi.
过来 guòlái: đủ, quá, đến, qua đây.
过去 guòqù: đã qua, đi qua
道歉 dàoqiàn: nhận lỗi, chịu lỗi.
选手 xuǎnshǒu: tuyển thủ, thí sinh.
选择 xuǎnzé: lựa chọn, tuyển chọn.
还是 háishì: vẫn, vẫn còn, không ngờ, hoặc.
还有 hái yǒu: vẫn còn.
还要 hái yào: còn muốn, vẫn muốn.
那些 nàxiē: những…ấy, những...đó, những...kia.
那个 nàgè: cái đó, việc ấy, ấy…
那儿 nàr: chỗ ấy, nơi ấy, lúc ấy, bây giờ.
那天 nèitiān: hôm đó.
那时 nà shí: lúc đó, khi đó.
那样 nàyàng: như vậy, như thế.
那种 nà zhǒng: loại đó.
那里 nàlǐ: chỗ ấy, chỗ đó, nơi ấy.
那边 nà biān: bên kia, bên ấy.
那么 nàme: như thế.
部分 bùfèn: bộ phận.
医生 yīshēng: bác sĩ, thầy thuốc.
医院 yīyuàn: bệnh viện.
重新 chóngxīn: lại lần nữa, làm lại từ đầu.
重要 zhòngyào: trọng yếu, quan trọng.
错误 cuòwù: sai lầm, lỗi lầm, lệch lạc.
钥匙 yàoshi: chìa khóa.
长官 zhǎngguān: quan trên, quan lớn.
开始 kāishǐ: bắt đầu, lúc đầu.
开心 kāixīn: vui vẻ.
开枪 kāi qiāng: mở súng.
关系 guānxì: quan hệ, liên quan đến.
关心 guānxīn: quan tâm.
关于 guānyú: về…
阻止 zǔzhǐ: ngăn trở, ngăn cản
除了 chúle: ngoài ra, trừ ra.
除非 chúfēi: trừ khi,ngoài ra.
随便 suíbiàn: tùy tiện, tùy, tùy ý, bất cứ.
虽然 suīrán: mặc dù.
离开 líkāi: rời khỏi, tách khỏi, ly khai.
难道 nándào: thảo nào, lẽ nào.
电影 diànyǐng: điện ảnh, phim.
电视 diànshì: ti vi, vô tuyến.
电话 diànhuà: máy điện thoại, điện thoại.
需要 xūyào: cần, yêu cầu.
非常 fēicháng: bất thường, rất, vô cùng.
音乐 yīnyuè: âm nhạc
头发 tóufà: tóc
愿意 yuànyì: vui lòng, bằng lòng, hy vọng.
显然 xiǎnrán: hiển nhiên.
飞机 fēijī: máy bay, phi cơ.
首先 shǒuxiān: đầu tiên.
马上 mǎshàng: lập tức, tức khắc.
高兴 gāoxìng: vui vẻ, vui mừng, phấn chấn, thích.
麻烦 máfan: phiền phức, rắc rối.
